C   0,0,80
R 600 500
NO textures/wood.xpm
   SO       textures/blue.xpm
WE textures/grey.xpm
EA textures/brick.xpm
S textures/barrel.xpm   
   F      220,100,0


        1111111111111111111111111
        1000000000110000000000001
        1011000001110000002000001
        10010000000E0000000000001
111111111011000001100000000000001
100000000010000011101111111111111
11110111111111011100000010001
11110111111111011101010010001
11000000110101011100000010001
10002000000000001100000000001
10000000000000001101010010001
1100000111010101110101101000111
11110111011101010101111010001
11111111011111110111111110001
10000000000000000000000000001
11111111111111111111111111111