R 1080 720
NO ./textures/brick.xpm
SO ./textures/blue.xpm
WE ./textures/wood.xpm
EA ./textures/grey.xpm

S ./textures/pillar.xpm
F 224,172,105
C 205,249,255

11111111111111111
10000000200000001
10000000000000001
10000000000000001
10000000200000001
10000000000000001
10000000000000001
10000000000000001
10000000200000001
10000000000000001
10000000N00000001
11111111111111111